10 10 2
@@@@@@@@@@
@........@
@........|
@........@
@........@
@........@
@........@
@........@
@K.......@
@@@@@@@@@@
@@@@@@@@@@
@..K.....@
@@@@.....@
@........@
@...@@@@@@
@.....@@@@
@.....@@@@
@........@
@@@@.....@
@...C....@